15 15
10 1 1 1 11 -1 -1 -1 -1 10 1 1 1 1 11 
12 3 3 3 13 -1 -1 -1 -1 12 3 3 3 3 13 
5 -1 -1 -1 4 1 1 1 1 5 -1 -1 -1 -1 4 
5 -1 -1 -1 6 3 3 3 3 7 -1 -1 -1 -1 4 
5 -1 -1 -1 -1 -1 -1 -1 -1 -1 -1 -1 -1 -1 4 
5 -1 -1 -1 8 1 1 1 1 9 -1 -1 -1 -1 4 
14 1 1 1 15 3 3 3 3 14 1 9 8 1 15 
16 3 3 3 17 -1 -1 -1 -1 16 3 5 4 3 17 
10 1 1 1 11 -1 -1 -1 -1 10 1 5 4 1 11 
12 3 3 3 13 -1 -1 -1 -1 12 3 7 6 3 13 
5 -1 -1 -1 4 1 1 1 1 5 -1 -1 -1 -1 4 
5 -1 -1 -1 6 3 3 3 3 7 -1 -1 -1 -1 4 
5 -1 -1 -1 8 1 1 1 1 9 -1 -1 -1 -1 4 
14 1 1 1 15 3 3 3 3 14 1 1 1 1 15 
16 3 3 3 17 -1 -1 -1 -1 16 3 3 3 3 17 
-1 -1 -1 -1 -1 -1 -1 -1 -1 -1 -1 -1 -1 -1 -1 
-1 -1 -1 -1 -1 -1 -1 -1 -1 -1 -1 -1 -1 -1 -1 
0 0 0 0 0 -1 -1 -1 -1 0 0 0 0 0 0 
0 0 0 0 0 -1 -1 -1 -1 0 0 0 0 0 0 
0 0 0 0 0 0 0 0 0 0 0 0 0 0 0 
0 0 0 0 0 0 0 0 0 0 0 0 0 0 0 
0 0 0 0 0 0 0 0 0 0 0 0 0 0 0 
0 0 0 0 0 -1 -1 -1 -1 0 0 0 0 0 0 
-1 -1 -1 -1 -1 -1 -1 -1 -1 -1 -1 0 0 -1 -1 
-1 -1 -1 -1 -1 -1 -1 -1 -1 -1 -1 0 0 -1 -1 
0 0 0 0 0 -1 -1 -1 -1 0 0 0 0 0 0 
0 0 0 0 0 -1 -1 -1 -1 0 0 0 0 0 0 
0 0 0 0 0 0 0 0 0 0 0 0 0 0 0 
0 0 0 0 0 0 0 0 0 0 0 0 0 0 0 
0 0 0 0 0 -1 -1 -1 -1 0 0 0 0 0 0 
9
7.5 1.25 15.0 1.5
0.125 7.875 0.25 14.25
5.625 8.75 11.25 2.5
7.0 3.0 4.5 2.0
7.0 9.25 4.5 5.5
7.5 14.75 15.0 0.5
7.0 14.25 4.5 1.5
13.875 8.75 2.25 2.5
14.875 7.875 0.25 14.25
